1111111111
1E0011C0C1
101C100C11
1P00000011
1111111111